+++++++++++++++++++++++                     
++            +     +++                 
++            +     +++                  
++            +     +++                 
++            +     +++                 
++    ###     +##   +++                 
++####;,)      ;]   +++                 
++,;,]              +++                 
++              ¢   +++                 
++                  +++                 
++                  +++                 
++                  +++                 
++                  +++                 
++                  +++                 
+++++++++++++++++++++++                 
+                     +                 
+                     +                 
+++++++++++++++++++++++                    
