+++++++++++++++++++++++                     
++                  +++                 
++                  +++                  
++                  +++                 
++                  +++                 
++                  +++                 
++                  +++                 
++                  +++                 
++                  +++                 
++                  +++                 
++                  +++                 
++               ¥  +++                 
++                  +++                 
++     &     &      +++                 
+++++++++++++++++++++++                 
+                     +                 
+                     +                 
+++++++++++++++++++++++                    
