+++++++++++++++++++++++                     
++                  +++                 
++                  +++                  
++                  +++                 
++                  +++                 
++                  +++                 
++                  +++                 
++                  +++                 
++                  +++                 
++                  +++                 
++                  +++                 
++                ? +++                 
++                  +++                 
++                  +++                 
+++++++++++++++++++++++                 
+                     +                 
+                     +                 
+++++++++++++++++++++++                    
