+++++++++++++++++++++++++++++++++++++++++++++++++++++++++++++++++++++++++++++++++++++++++++++++++++++++++++++++++++++++++++++++++++++++++++++++++++++++++++++++++++++++++++++++++++++++++++++++++++++++++++++++++++++++++++++++++++++++++++++++++++++++++++++++   
+                                                                                                                                                                                                                                                             +
+                                                         ----------------------                                                                                                        Ç                                                                     +
+                                                         ----------------------                                                                                                                                                                              +
+                                                         ----------------------                                                                                                                                                                              +
+                                                         ----------------------                                               Ü  v1         &                                                                                                           §    +
+                                                         ----------------------                       Ç                    <1           __________                    T   Ü _______       ª                                                           &      +
+                                                         ----------------------                                                                        ------    --------             -------                &            &                    v2    ________+
+                                                         ----------------------                                      <2                                                                         __  ____     _    _    _  _   __  ---   -  --                +
+                                                         ----------------------                                   Ü                                                                                                                                          +
+                                                         ----------------------                                <3                                                                                                                                            +
+                                                         ----------------------                                                                                                                                                                              +
+                                                         ----------------------               ____    -----                                                                                                                                                  +
+                                                          /\ \/\/\/\ \/\/ /\/           &                                                                                                                                                                    +
+                                                   -  -  ----__----__----__----__     ____                                                                                                                                                                   +
+                                               -   -  -                                                                                                                                                                                                      +
+     v1    v2    \ \ \ & \ \ \\            -   -   -  -                                                                                                                                                                                                      +
+              __________________----   --  -   -   -  -                                                                                                                                                                                                      +
+                                                                                                                                                                                                                                                             +
+                                                                                                                                                                                                                                                             +
+++++++++++++++++++++++++++++++++++++++++++++++++++++++++++++++++++++++++++++++++++++++++++++++++++++++++++++++++++++++++++++++++++++++++++++++++++++++++++++++++++++++++++++++++++++++++++++++++++++++++++++++++++++++++++++++++++++++++++++++++++++++++++++++   
