+++++++++++++++++++++++                     
++                  +++                 
++                  +++                  
++                  +++                 
++                  +++                 
++                  +++                 
++                  +++                 
++                  +++                 
++                  +++                 
++                  +++                 
++                  +++                 
++               £  +++                 
++                  +++                 
++&       &    &    +++                 
+++++++++++++++++++++++                 
+                     +                 
+                     +                 
+++++++++++++++++++++++                    
