+++++++++++++++++++++++++++++++++++++++++++++++++++++++++++++++++++++++++++++++++++++++++++++++++++++++++++++++++++++++++++++++++++++++++++++++++++++++++++++++++++++++++++++++++++++++++++++++++++++++++++++++++++++++++++++++++++++++++++++++++++++++++++++++   
+                                                                                                                                                                                                                                                             +
+                                                                                                                                                                                                                                                             +
+                                                                                                                                                                                                                                          -       ---------  +
+                                                                                                           Ç                                                                                                                              -    §   Æ   Æ     +
+                                                                                                                                                                                                                                       ƒ ß-                  +
+                                                                                                                                                                                                                                          --------           +
+                                                                                                                                                                --------------                                                         %%%        °      •   +
+                                                                                                               S                        S                         Æ   Æ   Æ                                                   %%%%%%             ----*       +
+                                                                       µ                                                       <3        ±                                      H               Ç                                                     -----  +
+                                                                                        H         &      ---------    ----^^^^^^^^^^^^-----                         ß       °                                     %%%%%%%%                        •          +
+                                                                    ++++++  v1                  ______                   --------------         __      ___     --------------                         H                                         ----    °   +
+                                                                                 v1         %%                                                                                                         -    v2                                       -       +
+                                                          +    _                        <3                                                                                         &&        ----------                                               *----  +
+                                                      __                                                                                                                          _______                          & µ &                          ƒ µ    H   +
+             H                                  H _                                                                                                                                                                _____                         ######      +
+                       &                                                                                                                                                                                                               ±    &  &             +
+----------------     #_____      <     --------                                                                                                                                                                              _____     ____ ________^^^^^^^^^+
+                                                                                                                                                                                                                                                   __________+
+                                                                                                                                                                                                                                                             +
+++++++++++++++++++++++++++++++++++++++++++++++++++++++++++++++++++++++++++++++++++++++++++++++++++++++++++++++++++++++++++++++++++++++++++++++++++++++++++++++++++++++++++++++++++++++++++++++++++++++++++++++++++++++++++++++++++++++++++++++++++++++++++++++   
