+++++++++++++++++++++++++++++++++++++++++++++++++++++++++++++++++++++++++++++++++++++++++++++++++++++++++++++++++++++++++++++++++++++++++++++++++++++++++++++++++++++++++++++++++++++++++++++++++++++++++++++++++++++++++++++++++++++++++++++++++++++++++++++++   
+                                                                                                                                                                                                                               Ç                             +
+                                                                                                                                                                                                                                                             +
+                                                                                                                                                                                                                                        ƒ                    +
+                                                                                                                                                                                                                                           µ                 +
+                                                                                                                                                                                                                                                      ƒ      +
+                                                                                                                                                                                                                                  ß                          +
+                                                                                                                                                                                                                                                ±      ƒ     +
+                                                                                                                                                                                                                        #####################################+
+                                                                                                                                                                                                                          Æ      Æ     Æ                     +
+                                                                                                                                                                                                     %%%--%%%--%%---                                         +
+                                                                                                 ß   Ç                                                                            *       Ç                                                                  +
+                                                                                                                                                                                   --       -------               ƒ   &      &                  &            +
+                             J                                                                   º                                             T  &                                  ----                      __ __________________--------^^^____^^^---****+
+                                                                                              ª  _                                         __%%_____                      ±    G &                         _   -- ----      o           o   ---   o---oO     +
+                J         J              J              H                 ƒ                   _  -                             ___%%___               %__           ___   +   _____                   _    -   -- ----§           h                          +
+                    J             J                              ª     º      S &             -  -                             t                        t µ                                G     _    -    -   -- ----      &                o           G   +
+-----------------^^----^^--- --^^^-----^^-^^-----  <     ------  -  -  -  -  _____   -------- -  -  --------  <2    >2  -----                             ------                    ----------   -    -    -   -- ----__   __   ___  V1 --------------- _^^^^+
+                           + +                  +        +                   +                                                                                                                   -    -    -   -- ----                                       +
+                            +                    ++++++++                    +                                                                                                                                                                               +
+++++++++++++++++++++++++++++++++++++++++++++++++++++++++++++++++++++++++++++++++++++++++++++++++++++++++++++++++++++++++++++++++++++++++++++++++++++++++++++++++++++++++++++++++++++++++++++++++++++++++++++++++++++++++++++++++++++++++++++++++++++++++++++++   
